```````````
```````````
```````````
```````````
===========
===========
===========
````===````
````===````
````===````
````===````
