```````````
```````````
```````````
```````````
````=======
````=======
````=======
````===````
````===````
````===````
````===````
