```````````
```````````
```````````
```````````
`==========
`==========
`==========
````===````
````===````
````===````
````===````
