````===````
````===````
````===````
````===````
````===````
````===````
````=======
````=======
````=======
"""""""""""
+++++++++++
