1c ````===````
   ````===````
   ````===````
   ````===````
   ````===````
   ````===````
   ````=======
   ````=======
   ````=======
   """""""""""
   ~~~~~~~~~~~
