~~~~~~~~~~~
"""""""""""
"""""""""""
```````````
```========
``=========
``=========
``===``````
``===``````
``===``````
``===``````
