1e ``===``````
   ``===``````
   ``===``````
   ``===``````
   ``===``````
   ``=========
   ``=========
   ```========
   ```````````
   ```````````
   ```````````
