```````````
```````````
```````````
``=========
`==========
``=========
````===````
````===````
````===````
````===````
````===````
