````===````
````===````
````===````
````===````
````===````
````===````
=========== 
===========
===========
"""""""""""
~~~~~~~~~~~
