~~~~~~~~~~~
"""""""""""
"""``""`"""
```````````
=======````
========```
========```
```=====```
```=====```
````===````
```````````
