```````````
```````````
```````````
```````````
=========``
==========`
=========`` 
```````````
```````````
```````````
```````````
