```````````
```````````
```````````
```````````
```````````
```````````
===========
===========
===========
""""===""""
++++===++++
