++++===++++
""""===""""
````===````
````===````
````===````
````===````
````===````
````===````
````===````
````===````
````===````
