````===````
````===````
````===````
````===````
````===````
===========
===========
===========
```````````
```````````
```````````
