```````````
```````````
```````````
```````````
=====``````
======`````
=======````
```====````
````===````
````===````
````===````
