````===````
````===````
````===````
````===````
````===````
```====````
=======````
======`````
=====``````
"""""""""""
+++++++++++ 
 
