```````````
```````````
```````````
`````=`````
````===````
````===````
````===````
````===````
````===````
````===````
````===````
