````===````
````===````
````===````
````===````
```====````
=======````
======`````
=====``````
```````````
```````````
```````````
