```````````
```````````
```````````
```````````
````===````
```=====```
```=====```
````===````
```````````
```````````
```````````
