```````````
```````````
```````````
```````````
```````````
```````````
======`````
```====````
````===````
"""""="""""
+++++++++++

