+++++++++++
"""""""""""
```````````
```````````
```````````
```````````
```````````
```````````
```````````
```````````
```````````

