````````````
`==========`
````````````
````````````
````````````
````````````
`""""""""""`
````````````
````````````
````````````
