"""""""""""
```````````
```````````
```````````
```````````
```````````
~~~~~~~~~~~
```````````
```````````
===========

